1111111111111111111
1P00000000000000001
10000000000C0000011
1000000000000000001
10000000C00000010E1
1111111111111111111