1111111111111
10C1P0000E0C1
1111111111111
