11111111111111111111
11P100000000C00001E1
10100000000000000101
10000000000000000101
10000000000000000101
11111111111111111111