111111111111
1P0000000C01
111111111111