111111111
10P000001
100000E01
111111111