1111111111
1E0000C001
1111111111