11111111111
10000000000
1P000C000E1
11111111111